"a" = (/turf/template_noop,/area/template_noop)
"g" = (/obj/machinery/computer/shuttle/white_ship/bridge{dir = 8},/turf/open/floor/plating/airless,/area/shuttle/abandoned)
"h" = (/obj/machinery/computer/camera_advanced/shuttle_docker/whiteship{dir = 8; x_offset = -2; y_offset = -8},/turf/open/floor/plating/airless,/area/shuttle/abandoned)
"m" = (/turf/open/floor/plating/airless,/area/shuttle/abandoned)
"E" = (/obj/docking_port/mobile{dir = 2; dwidth = 6; height = 30; launch_status = 0; name = "White Ship"; port_direction = 2; shuttle_id = "whiteship"; width = 60},/turf/open/floor/plating/airless,/area/shuttle/abandoned)
//MAP CONVERTED BY dmm2tgm.py THIS HEADER COMMENT PREVENTS RECONVERSION, DO NOT REMOVE
"a" = (
/turf/template_noop,
/area/template_noop)
"b" = (
/turf/closed/wall/mineral/titanium,
/area/shuttle/abandoned)
"c" = (
/obj/machinery/power/shuttle_engine/propulsion/burst{
	dir = 1
	},
/turf/closed/wall/mineral/titanium,
/area/shuttle/abandoned)
"d" = (
/obj/machinery/door/airlock/public/glass{
	name = "Shuttle Airlock"
	},
/turf/open/floor/iron/dark,
/area/shuttle/abandoned)
"e" = (
/turf/open/floor/iron/dark,
/area/shuttle/abandoned)
"f" = (
/turf/open/floor/iron,
/area/shuttle/abandoned)
"g" = (
/obj/machinery/power/shuttle_engine/propulsion/burst{
	dir = 8
	},
/turf/closed/wall/mineral/titanium,
/area/shuttle/abandoned)
"h" = (
/obj/structure/window/reinforced{
	dir = 1;
	layer = 2.9
	},
/obj/structure/window/reinforced{
	dir = 8
	},
/obj/structure/table/glass,
/obj/item/gun/medbeam,
/turf/open/floor/plating/abductor,
/area/shuttle/abandoned)
"i" = (
/obj/machinery/computer/camera_advanced/shuttle_docker/whiteship,
/turf/open/floor/plating/abductor,
/area/shuttle/abandoned)
"j" = (
/obj/structure/window/reinforced{
	dir = 1;
	layer = 2.9
	},
/obj/structure/window/reinforced{
	dir = 4
	},
/obj/structure/table/glass,
/obj/machinery/recharger,
/obj/item/gun/energy/laser/retro,
/turf/open/floor/plating/abductor,
/area/shuttle/abandoned)
"k" = (
/obj/machinery/power/shuttle_engine/propulsion/burst{
	dir = 4
	},
/turf/closed/wall/mineral/titanium,
/area/shuttle/abandoned)
"l" = (
/obj/structure/chair/comfy/shuttle{
	dir = 4
	},
/turf/open/floor/plating/abductor,
/area/shuttle/abandoned)
"m" = (
/turf/open/floor/plating/abductor,
/area/shuttle/abandoned)
"n" = (
/obj/structure/chair/comfy/shuttle{
	dir = 8
	},
/turf/open/floor/plating/abductor,
/area/shuttle/abandoned)
"o" = (
/obj/machinery/door/airlock/public/glass{
	name = "Shuttle Airlock"
	},
/obj/docking_port/mobile{
	dir = 8;
	dwidth = 4;
	height = 9;
	shuttle_id = "whiteship";
	launch_status = 0;
	name = "White Ship";
	port_direction = 4;
	width = 9
	},
/turf/open/floor/iron/dark,
/area/shuttle/abandoned)
"p" = (
/obj/structure/window/reinforced{
	dir = 8
	},
/obj/structure/window/reinforced,
/obj/structure/table/glass,
/obj/item/tank/internals/oxygen,
/obj/item/clothing/mask/breath,
/obj/item/clothing/suit/space/eva,
/obj/item/clothing/head/helmet/space/eva,
/turf/open/floor/plating/abductor,
/area/shuttle/abandoned)
"q" = (
/obj/machinery/computer/shuttle/white_ship/bridge{
	dir = 1
	},
/turf/open/floor/plating/abductor,
/area/shuttle/abandoned)
"r" = (
/obj/structure/window/reinforced{
	dir = 4
	},
/obj/structure/window/reinforced,
/obj/structure/table/glass,
/obj/item/clothing/shoes/magboots,
/turf/open/floor/plating/abductor,
/area/shuttle/abandoned)
"s" = (
/obj/machinery/power/shuttle_engine/propulsion/burst,
/turf/closed/wall/mineral/titanium,
/area/shuttle/abandoned)

(1,1,1) = {"
aaaaaaaaaaaaaaaaaaaaaaaaaaaaaaaaaaaaaaaaaaaaaaaaaaaaaaaaaaaa
aaaaaaaaaaaaaaaaaaaaaaaaaaaaaaaaaaaaaaaaaaaaaaaaaaaaaaaaaaaa
aaaaaaaaaaaaaaaaaaaaaaaaaaaaaaaaaaaaaaaaaaaaaaaaaaaaaaaaaaaa
aaaaaaaaaaaaaaaaaaaaaaaaaaaaaaaaaaaaaaammmmmmaaaaaaaaaaaaaaa
mmmmmmmmmmmmmmmaaaaaaaaaammEmmaaaaaaaaammmmmmmaaaaaaaaaaaaaa
mmmmmmmmmmmmmmmmaaaaaaaaammmmmaaaaaaaaammmmmmmmaaaaaaaaaaaaa
mmmmmmmmmmmmmmmmaaaaaaaammmmmmmaaaaaaaammmmmmmmmmmmmmmmmaaaa
mmmmmmmmmmmmmmmmmaaaaaammmmmmmmmaaaaaaammmmmmmmmmmmmmmmmmaaa
mmmmmmmmmmmmmmmmmmmmmmmmmmmmmmmmmmmmmmmmmmmmmmmmmmmmmmmmmmaa
mmmmmmmmmmmmmmmmmmmmmmmmmmmmmmmmmmmmmmmmmmmmmmmmmmmmmmmmmmma
mmmmmmmmmmmmmmmmmmmmmmmmmmmmmmmmmmmmmmmmmmmmmmmmmmmmmmmmmmmm
mmmmmmmmmmmmmmmmmmmmmmmmmmmmmmmmmmmmmmmmmmmmmmmmmmmmmmmmmmmm
mmmmmmmmmmmmmmmmmmmmmmmmmmmmmmmmmmmmmmmmmmmmmmmmmmmmmmmmmmmm
mmmmmmmmmmmmmmmmmmmmmmmmmmmmmmmmmmmmmmmmmmmmmmmmmmmmmmmmmmmm
mmmmmmmmmmmmmmmmmmmmmmmmmmmmmmmmmmmmmmmmmmmmmmmmmmmmmmmmmmgm
mmmmmmmmmmmmmmmmmmmmmmmmmmmmmmmmmmmmmmmmmmmmmmmmmmmmmmmmmmhm
mmmmmmmmmmmmmmmmmmmmmmmmmmmmmmmmmmmmmmmmmmmmmmmmmmmmmmmmmmmm
mmmmmmmmmmmmmmmmmmmmmmmmmmmmmmmmmmmmmmmmmmmmmmmmmmmmmmmmmmmm
mmmmmmmmmmmmmmmmmmmmmmmmmmmmmmmmmmmmmmmmmmmmmmmmmmmmmmmmmmmm
mmmmmmmmmmmmmmmmmmmmmmmmmmmmmmmmmmmmmmmmmmmmmmmmmmmmmmmmmmmm
mmmmmmmmmmmmmmmmmmmmmmmmmmmmmmmmmmmmmmmmmmmmmmmmmmmmmmmmmmma
mmmmmmmmmmmmmmmmmmmmmmmmmmmmmmmmmmmmmmmmmmmmmmmmmmmmmmmmmmaa
mmmmmmmmmmmmmmmmmaaaaaammmmmmmmmaaaaaaammmmmmmmmmmmmmmmmmaaa
mmmmmmmmmmmmmmmmaaaaaaaammmmmmmaaaaaaaammmmmmmmmmmmmmmmmaaaa
mmmmmmmmmmmmmmmmaaaaaaaaammmmmaaaaaaaaammmmmmmmaaaaaaaaaaaaa
mmmmmmmmmmmmmmmaaaaaaaaaammmmmaaaaaaaaammmmmmmaaaaaaaaaaaaaa
aaaaaaaaaaaaaaaaaaaaaaaaaaaaaaaaaaaaaaammmmmmaaaaaaaaaaaaaaa
aaaaaaaaaaaaaaaaaaaaaaaaaaaaaaaaaaaaaaaaaaaaaaaaaaaaaaaaaaaa
aaaaaaaaaaaaaaaaaaaaaaaaaaaaaaaaaaaaaaaaaaaaaaaaaaaaaaaaaaaa
aaaaaaaaaaaaaaaaaaaaaaaaaaaaaaaaaaaaaaaaaaaaaaaaaaaaaaaaaaaa
"}
