"a" = (/turf/template_noop,/area/template_noop)
"g" = (/obj/machinery/computer/shuttle/white_ship/bridge{dir = 8},/turf/open/floor/plating/airless,/area/shuttle/abandoned)
"j" = (/obj/machinery/computer/camera_advanced/shuttle_docker/whiteship{dir = 8; x_offset = -2; y_offset = -8},/turf/open/floor/plating/airless,/area/shuttle/abandoned)
"m" = (/obj/docking_port/mobile{dir = 2; dwidth = 6; height = 30; launch_status = 0; name = "White Ship"; port_direction = 2; shuttle_id = "whiteship"; width = 60},/turf/open/floor/plating/airless,/area/shuttle/abandoned)
"P" = (/turf/open/floor/plating/airless,/area/shuttle/abandoned)

(1,1,1) = {"
aaaaaaaaaaaaaaaaaaaaaaaaaaaaaaaaaaaaaaaaaaaaaaaaaaaaaaaaaaaa
aaaaaaaaaaaaaaaaaaaaaaaaaaaaaaaaaaaaaaaaaaaaaaaaaaaaaaaaaaaa
aaaaaaaaaaaaaaaaaaaaaaaaaaaaaaaaaaaaaaaaaaaaaaaaaaaaaaaaaaaa
aaaaaaaaaaaaaaaaaaaaaaaaaPPmPPaaaaaaaaaPPPPPPaaaaaaaaaaaaaaa
PPPPPPPPPPPPPPPaaaaaaaaaaPPPPPaaaaaaaaaPPPPPPPaaaaaaaaaaaaaa
PPPPPPPPPPPPPPPPaaaaaaaaaPPPPPaaaaaaaaaPPPPPPPPaaaaaaaaaaaaa
PPPPPPPPPPPPPPPPaaaaaaaaPPPPPPPaaaaaaaaPPPPPPPPPPPPPPPPPaaaa
PPPPPPPPPPPPPPPPPaaaaaaPPPPPPPPPaaaaaaaPPPPPPPPPPPPPPPPPPaaa
PPPPPPPPPPPPPPPPPPPPPPPPPPPPPPPPPPPPPPPPPPPPPPPPPPPPPPPPPPaa
PPPPPPPPPPPPPPPPPPPPPPPPPPPPPPPPPPPPPPPPPPPPPPPPPPPPPPPPPPPa
PPPPPPPPPPPPPPPPPPPPPPPPPPPPPPPPPPPPPPPPPPPPPPPPPPPPPPPPPPPP
PPPPPPPPPPPPPPPPPPPPPPPPPPPPPPPPPPPPPPPPPPPPPPPPPPPPPPPPPPPP
PPPPPPPPPPPPPPPPPPPPPPPPPPPPPPPPPPPPPPPPPPPPPPPPPPPPPPPPPPPP
PPPPPPPPPPPPPPPPPPPPPPPPPPPPPPPPPPPPPPPPPPPPPPPPPPPPPPPPPPPP
PPPPPPPPPPPPPPPPPPPPPPPPPPPPPPPPPPPPPPPPPPPPPPPPPPPPPPPPPPgP
PPPPPPPPPPPPPPPPPPPPPPPPPPPPPPPPPPPPPPPPPPPPPPPPPPPPPPPPPPjP
PPPPPPPPPPPPPPPPPPPPPPPPPPPPPPPPPPPPPPPPPPPPPPPPPPPPPPPPPPPP
PPPPPPPPPPPPPPPPPPPPPPPPPPPPPPPPPPPPPPPPPPPPPPPPPPPPPPPPPPPP
PPPPPPPPPPPPPPPPPPPPPPPPPPPPPPPPPPPPPPPPPPPPPPPPPPPPPPPPPPPP
PPPPPPPPPPPPPPPPPPPPPPPPPPPPPPPPPPPPPPPPPPPPPPPPPPPPPPPPPPPP
PPPPPPPPPPPPPPPPPPPPPPPPPPPPPPPPPPPPPPPPPPPPPPPPPPPPPPPPPPPa
PPPPPPPPPPPPPPPPPPPPPPPPPPPPPPPPPPPPPPPPPPPPPPPPPPPPPPPPPPaa
PPPPPPPPPPPPPPPPPaaaaaaPPPPPPPPPaaaaaaaPPPPPPPPPPPPPPPPPPaaa
PPPPPPPPPPPPPPPPaaaaaaaaPPPPPPPaaaaaaaaPPPPPPPPPPPPPPPPPaaaa
PPPPPPPPPPPPPPPPaaaaaaaaaPPPPPaaaaaaaaaPPPPPPPPaaaaaaaaaaaaa
PPPPPPPPPPPPPPPaaaaaaaaaaPPPPPaaaaaaaaaPPPPPPPaaaaaaaaaaaaaa
aaaaaaaaaaaaaaaaaaaaaaaaaPPPPPaaaaaaaaaPPPPPPaaaaaaaaaaaaaaa
aaaaaaaaaaaaaaaaaaaaaaaaaaaaaaaaaaaaaaaaaaaaaaaaaaaaaaaaaaaa
aaaaaaaaaaaaaaaaaaaaaaaaaaaaaaaaaaaaaaaaaaaaaaaaaaaaaaaaaaaa
aaaaaaaaaaaaaaaaaaaaaaaaaaaaaaaaaaaaaaaaaaaaaaaaaaaaaaaaaaaa
"}
